# Wall map: 0=empty, 1=stone wall, 2=brick wall, 3=metal wall, 4=door
1 1 1 1 1 1 1 1 1 1 1 1 1 1 1 1
1 0 0 0 0 0 0 0 0 0 0 0 0 0 0 1
1 0 0 0 0 0 0 0 0 0 0 0 0 0 0 1
1 0 0 2 2 2 0 0 0 3 3 0 0 0 0 1
1 0 0 2 0 0 0 0 0 3 0 0 0 0 0 1
1 0 0 2 0 0 0 0 0 0 0 0 0 0 0 1
1 0 0 0 0 0 0 0 0 0 0 0 0 0 0 1
1 0 0 0 0 0 1 4 1 0 0 0 0 0 0 1
1 0 0 0 0 0 1 0 1 0 0 0 0 0 0 1
1 0 0 0 0 0 1 0 1 0 0 0 0 0 0 1
1 0 0 0 0 0 1 0 1 0 2 2 2 2 0 1
1 0 0 0 0 0 0 0 0 0 2 0 0 2 0 1
1 0 0 0 0 0 0 0 0 0 2 0 0 2 0 1
1 0 0 0 0 0 0 0 0 0 2 2 4 2 0 1
1 0 0 0 0 0 0 0 0 0 0 0 0 0 0 1
1 1 1 1 1 1 1 1 1 1 1 1 1 1 1 1
